V V V V V V V V G G G G
L L L L L b L V V V V V
V V V V V V L L L L L V
G@G@G@G@G@V L V V V L V
GPG W G G@V L V GfV L V
G G W GEG@VEL V GfV L V
G G W G G V LEV GfV L V
G G w G G@V L V GfV L V
GEG W GEG V V V GfV L V
1234567890123
