V V V V V V V V
V L L L L L L V
V V VEV L L V V
V V L L L L L V
V V V L V V V V
V L L L L L V V
V V V V V V V VE
GfGfGfGfGfGfGfGf
1 2 3 4 5 6 7 8
