W W W W W W W W W W W W W
W CPC C C C C C C C C C W
W CES S S S S S S S S C W
W C SEG G G G G@G@G S C W
W C S G G G G@G@G G S C W
W C S S S S S S S S S C W
W C C C C C C C C C C C W
W W W W W W C W CpW W W W
W C C C C C C C C C C C W
W C S S S S S S S S S C W
W C S G G G G G@G@G S C W
W C S S S S S S S S S C W
W C C C C C C C C C C C W
W W W W W W W W W W W W W
0 1 2 3 4 5 6 7 8 9 0 1 2
