G G G G G G S w w S G G
G G G G G G G S w w S w
G G G G G G G G S w w w
G G G G G G G G S w w w
G G G G G G G G G S w w
G G G G G G G G G G S w
G G G H G G G G G H H W
G G H H G H H H H M H W
G H H H H H H H H M I W
H H H H H H H H H M I W
H H H M H M H H M M I W
H H M M H M M H M I I I
1 2 3 4 5 6 7 8 9 0 1 2
