u M M u+M u+u
u M u u u M u
u M u ucu M u
u u u M u u u
1 2 3 4 5 6 7
