W W W W W W W W W W W W W
W w w w w w w w w w w w W
W w S S S S S S S S S w W
W w S G G G G @ @ G S w W
W w S G G G @ @ G G S w W
W w S S S S S S S S S w W
W w w w w w w w w w w w W
W W W W W W w W W W W W W
W w w w w w w w w w w w W
W w S S S S S S S S S w W
W w S G G G G @ @ G S w W
W w S S S S S S S S S w W
W w w w w w w w w w w w W
W W W W W W W W W W W W W
0 1 2 3 4 5 6 7 8 9 0 1 2
