G G G G S w w S G G
G G G S w w S|G G@G
G G S w w S G|G@G@G
G S w w S G G\G@G@G
G W W W W G G G-G-G
G W W W G G G G G G
G G G G G G G G G G
G H H H G G G G G G
G H M H G G G G G G
G H H H G G G G G G
1 2 3 4 5 6 7 8 9 0
