u M M uLM uLu
u M u u u M u
u M u u u M u
u u u M u u u
1 2 3 4 5 6 7
