G G G GmG G H HvH H H HvH HvH
G G G GmG G H HvH H H HvH HvH
G G G GgG G H HvH H H HvH HvH
G G G GgG G H HvH H H HvH HvH
G G G GmG G H HvH H H HvH HvH
G G G GmG G H H H H H HvHlHvHl
G G G GmG G H HvHvHvH HvH HvH
G G G GmG G H HvHeHvH HvH HvH
G G G GmG G H HvH HvH HvH HvH
G G G GmG G H HvH H H HvH HvH
G G G GmG G H HvH H H HvH HvH
G G G GmG G H HvHvHvHvHvH HvH
1 2 3 4 5 6 7 8 9 0 1 2 3 4
