G GcG GmG G H HvH H H HvHcHvH H m m m
G G G GmG G H HvH H H HvH HvH H m m m
G G G GgG G H HvH H H HvH HvH H m m m
G G G GgG G H HvH H H HvH HvH H m m m
G G G GmG G H HvH H H HvH HvH H m m m
G G G GmG G H H H H H HvH-HvH-H G G m
G G G GmG G H HvHvHvH HvH HvH H G G m
G G G GmG G H HvHeHvH HvH HvH H m m m
G G G GmG G H HvH HvH HvH HvH H m m m
G G G GmG G H HvH H H HvH HvH H m m m
G G G GmG G H HvH H H HvH HvH H m m m
G G G GmG G H HvHvHvHvHvHcHvH H m m m
0 1 2 3 4 5 6 7 8 9 0 1 2 3 4
