V V V V VfV V V
VfL L L L V VfV
VfVfL L L L VfV
V L L L L L V V
VfL L L L L L V
V VfL L L L L V
V V V L L L L L
V V V V V V V V
1 2 3 4 5 6 7 8
