GGSwWwwSGGG
GSwwWwSGTTG
GSwwwWwSGTG
GSwwwwSGTTG
GSSwwSGGGGG
GGMSSMGTTGG
GGGGGGGGGGG
