GGGGGGSwwSGG
GGGGGGGSwwSw
GGGGGGGGSwww
GGGGGGGGSwww
GGGGGGGGGSww
GGGGGGGGGGSw
GGGHGGGGGHHW
GGHHGHHHHMHW
GHHHHHHHHMIW
HHHHHHHHHMIW
HHHMHMHHMMIW
HHMMHMMHMIII
