GGGGSSwwSwGG
GGGSSwwWwSGG
GGGSwwWwWSGG
GGSwwWwwSTTG
GGHHMHSwSTGG
GHHMHSwwSMGG
HHMMHSwSMHGG
HHHHSSwSMHGG
HMMSwwwSSMGT
MHHwwHwwwwST
MMMMwwMMMMMS
HHHHSwwwSHHH
