G H H H H H H w w w H M
H H M M M M w w H H G H
H M H H G w w G G G G G
M H H H G w G G G G G L
M I I I I w G L L L L L
M I M M I w G G G G G L
M I M M I W W W W G G G
M I M M I I I I W G I I
M I M M I I I I W I I H
M I M M H H I W W I H M
M H M M M H H I I H M M
M M M M M M M M M M M M
1 2 3 4 5 6 7 8 9 0 1 2
