GHHHHHHwwwHM
HHMMMMwwHHGH
HMHHGwwGGGGG
MHHHGwGGGGGL
MIIIIwGLLLLL
MIMMIwGGGGGL
MIMMIWWWWGGG
MIMMIIIIWGII
MIMMIIIIWIIH
MIMMHHIWWIHM
MHMMMHHIIHMM
MMMMMMMMMMMM
