GGGGGGGGGGGG
GGFGGGGTTTTG
GGFGGGGGGTGG
GGFFFFFGGTGG
GGHHHHGGGGGG
GGSSSHHHFGGG
GGSwwSHHFFGG
GGSwwwwwwFGG
GGGSSSHHHFGG
GGGGFFFGGGGG
GGGGGTTTGGGG
GGGGGGGGGTGG
