G G G G G G G G G G G G
G G G|G G G G G@G@G@GG
G G G|G G G G G G G@G G
G G G\G_G_G_G_G G G@G G
G G H H H H G G G G G G
G G S S S H H H G|G G G
G G S w w S H H G\G\G G
G G S w w w w w w G|G G
G G G S S S H H H G|G G
G G G G G_G_G_G G G G G
G G G G G G@G@G@G G G G
G G G G G G G G G G@G G
1 2 3 4 5 6 7 8 9 0 1 2
